     R    1500 1500
    NO textures/wood.xpm
  SO textures/purplestone.xpm
  WE textures/redbrick.xpm
EA textures/bluestone.xpm

S textures/barrel.xpm
F 255,  255, 255
C 255,255 ,0

111111111111111111111111
100000000011000000000001
101100000111000000000001
100100000000000000000001
101100000111000000000001
100000000011000001110111
111101111111111111000001
111101111010101011010101
110000001101010111000001
100000000000000011000001
100000000000000011010101
110000001101010111110111
111101111111011111110111
111101111111001011000001
110000011100000011000001
100000001100000011000001
100222001111111011100011
100000001111111110010101
110000011122211010100011
100020001000001101010101
100000000000000000000001
100000001000001101010101
11220001110N011010100011
111111111111111111111111